 #####
 #   #
 # #$##
##..@ #
# *.$ #
# # $##
#    #
######
Title: For ban 17
Collection: Novoban
Author: Francois Marques
AuthorMail: sokoban@online.fr
AuthorPage: http://sokoban.online.fr/
Date: 2001/03
