 #####
 #   #
##   ###
# $$$$ #
# .... #
## @ ###
 #####
Title: For ban 37
Collection: Novoban
Author: Francois Marques
AuthorMail: sokoban@online.fr
AuthorPage: http://sokoban.online.fr/
Date: 2001/03
